NO ./assets/textures/brick_1.xpm
SO ./assets/textures/brick_2.xpm
WE ./assets/textures/brick_3.xpm
EA ./assets/textures/brick_4.xpm

F 157,142,184
C 60,98,133


        1111111111111111111111111
        1000000000110000000000001
        1011000001110000000000001
        1001000000D00000000000001
111111111011000001110000000000001
10000000001100000111D111111111111
11110111111111011100000010011
1111D111111111011101010010001
11000000110101D1110000010001
10000000000000000D00000000001
10000000000000001101010000001
11000001110101011111011100E0111
11110111 1110101 101111010001
11111111 1111111 111011111111
                1000000000001
                1111111110111
                         1